+------------------------------+
+------------------------------+
+------------------------------+
+------------------------------+
+------------------------------+
+---------SSSSSSSSSSS----------+
+------------------------------+
+------------------------------+
+------------------------------+
+------------------------------+
+------------------------------+
+------------------------------+
+TTTTT--------------------TTTTT+
++++++--------------------++++++
++++++--------------------++++++
++++++--------------------++++++
++++++--------------------++++++
++++++--------------------++++++
++++++--------------------++++++
++++++--------------------++++++
++++++TTTTTTTTTTTTTTTTTTTT++++++
++++++++++++++++++++++++++++++++
++++++++++++++++++++++++++++++++
++++++++++++++++++++++++++++++++

+------------------------------+
+------------------------------+
+------------------------------+
+------------------------------+
+------------------------------+
+TTTT--------------------------+
+++++--------------------------+
+++++--------------------------+
+++++----TTTT------------------+
+++++----++++------------------+
+BBBB----BBBB------------------+
+------------------------------+
+------------------------------+
+------------------------------+
+----------------TTTT------TTTT+
+----------------BBBB------BBBB+
+------------------------------+
+------------------------------+
+------------------------------+
+------------------------------+
+--------------------TTTTTT----+
+--------------------BBBBBB----+
+------------------------------+
+------------------------------+

+BBBBBBBBBBBBB-----------------+
+------------------------------+
+------------------------------+
+------------------------------+
+------------------------------+
+SSSS--------------------------+
+------------------------------+
+------------------------------+
+----------TTTT----------------+
+----------BBBB----------------+
+------------------------------+
+------------------------------+
+------------------------------+
+-----------------TTTT---------+
+------------+++++++++---------+
+------------BBBBBBBBB---------+
+--------------------------TTTT+
+--------------------------BBBB+
+------------------------------+
+------------------------------+
+-------------TTTT----TTTT-----+
+-------------BBBB----BBBB-----+
+------------------------------+
+------------------------------+

+------------------------------+
+------------------------------+
+------------------------------+
+------------------------------+
+------------------------------+
+------------------------------+
+------------------------------+
+------------------------------+
+------------------------------+
+------------------------------+
+------------------------------+
+------------------------------+
+------------------------------+
+------------------------------+
+------------------------------+
+------------------------------+
+------------------------------+
+------------------------------+
+------------------------------+
+------------------------------+
+------------------------------+
+-------------------SSSSSSS----+
+------------------------------+
+------------------------------+

+------------------------------+
+------------------------------+
+------------------------------+
+------------------------------+
+------------------------------+
+------------------------------+
+------------------------------+
+------------------------------+
+------------------------------+
+------------------------------+
+------------------------------+
+------------------------------+
+------------------------------+
+------------------------------+
+------------------------------+
+------------------------------+
+------------------------------+
+------------------------------+
+------------------------------+
+------------------------------+
+------------------------------+
+-------------------SSSSSSS----+
+------------------------------+
+------------------------------+